＊セーブデータ
＄MEHチャプター観覧中	０
＄なでられ持続秒数	２
＄なでられ時実行イベント	なでられ時の反応
＄なでられ反応回数	６０
＄イケオス妊活テクニック済	０
＄オナホコキモード	０
＄オナホコキ開放フラグ	０
＄キャラ表示配列1	フーカ
＄キャラ表示配列10	男
＄キャラ表示配列2	ミニム
＄キャラ表示配列3	ユナ
＄キャラ表示配列4	マカナ
＄キャラ表示配列5	フィリオ
＄キャラ表示配列6	チナヨ
＄キャラ表示配列7	レレニー
＄キャラ表示配列8	ミナコ
＄キャラ表示配列9	スーリア
＄コース時間	１２０
＄コスプレシェルフラグ	０
＄コスプレ中Ｆ	０
＄コス状態維持フラグ	０
＄コス変更時トークフラグ	１
＄ゴースト起動時間累計(ms)	2000
＄ゴースト起動時間累計ミリ秒	2000
＄ゴースト起動時間累計秒	2
＄ゴム無限	０
＄スーリアユーザ名	あなた
＄スーリア起動回数	０
＄スーリア現在のコス	私服
＄スーリア交流ポイント	０
＄スーリア交流度	０
＄スーリア使用済ゴム１状態	０
＄スーリア使用済ゴム２状態	０
＄スーリア使用済ゴム３状態	０
＄スーリア使用済ゴム４状態	０
＄スーリア使用済ゴム５状態	０
＄スーリア使用済ゴム６状態	０
＄スーリア子宮精液量	０
＄スーリア生えっち解放フラグ	０
＄スーリア弟バレ認知フラグ	０
＄スーリア登場フラグ	０
＄スーリア髪型コス	ウェーブセミロング
＄スキンシップゲージ増加フラグ	０
＄スコープ切り換え時	\n[half]
＄ズボン下ろし済み	０
＄ズボン脱がし反応を挟む	０
＄チートモード中フラグ	０
＄チナヨユーザ名	お客さん
＄チナヨユーザ名２	オマエ
＄チナヨ起動回数	０
＄チナヨ現在のコス	JK制服
＄チナヨ交流ポイント	０
＄チナヨ交流度	０
＄チナヨ使用済ゴム１状態	０
＄チナヨ使用済ゴム２状態	０
＄チナヨ使用済ゴム３状態	０
＄チナヨ使用済ゴム４状態	０
＄チナヨ使用済ゴム５状態	０
＄チナヨ使用済ゴム６状態	０
＄チナヨ子宮精液量	０
＄チナヨ生えっちNG回数	０
＄チナヨ生えっち解放フラグ	０
＄チナヨ登場フラグ	０
＄チナヨ頭コス	白リボン
＄チナヨ髪型コス	ツーサイドアップ
＄チナヨ本性バレ	０
＄チナヨ本性モード	０
＄チンポの大きさ	１
＄ツールチップ表示	０
＄デバッグ	有効
＄デフォルトサーフェス0	0
＄デフォルトサーフェス1	10
＄デフォルトサーフェス100	999999
＄デフォルトサーフェス2	999999
＄デフォルトサーフェス3	999999
＄デフォルトサーフェス4	999999
＄デフォルトサーフェス5	999999
＄デフォルトサーフェス6	999999
＄デフォルトサーフェス7	999999
＄トーク中のなでられ反応	無効
＄バスローブ状態	０
＄フーカえっち配信見た	０
＄フーカらぶえっちＦ	０
＄フーカらぶえっち解放Ｆ	０
＄フーカ起動回数	０
＄フーカ巨根見た	０
＄フーカ交流ポイント	０
＄フーカ交流度	０
＄フーカ子宮精液量	０
＄フーカ体位	０
＄フーカ短小見た	０
＄フーカ配信中フラグ	０
＄フィリオ３Ｐ起動相手	０
＄フィリオアナル処女	０
＄フィリオオナホコキ経験フラグ	０
＄フィリオオナホコキ中フラグ	０
＄フィリオオナホ射精回数	０
＄フィリオゴム着用フラグ	１
＄フィリオユーザ名	お兄さん
＄フィリオ起動回数	０
＄フィリオ興奮度	０
＄フィリオ隙フラグ	０
＄フィリオ現在のコス	通常私服
＄フィリオ現在ポーズ	０
＄フィリオ交流ポイント	０
＄フィリオ交流度	０
＄フィリオ使用済ゴム１状態	０
＄フィリオ使用済ゴム２状態	０
＄フィリオ使用済ゴム３状態	０
＄フィリオ使用済ゴム４状態	０
＄フィリオ使用済ゴム５状態	０
＄フィリオ使用済ゴム６状態	０
＄フィリオ射精ゲージ	０
＄フィリオ射精回数	０
＄フィリオ射精状態	０
＄フィリオ男バレＦ	０
＄フィリオ登場フラグ	０
＄フィリオ童貞フラグ	０
＄フィリオ童貞卒業相手	０
＄フィリオ髪型コス	ショート
＄フェラ後射精フラグ	０
＄プライベートフーカと鉢合わせ	０
＄プライベートモード	０
＄プライベートモード予約	０
＄プライベート後	０
＄ペットテスト正解数	０
＄ボテ状態許可	０
＄ボテ腹カウント	０
＄ボテ腹状態	０
＄ボテ腹目撃済み	０
＄マカナえっちフラグ	０
＄マカナヘアピンコス	なし
＄マカナメイクコス	通常メイク
＄マカナユーザ名	お客さん
＄マカナ眼鏡コス	赤縁メガネ
＄マカナ眼鏡着用	１
＄マカナ起動回数	０
＄マカナ現在のコス	シスター服
＄マカナ交流ポイント	０
＄マカナ交流度	０
＄マカナ使用済ゴム１状態	０
＄マカナ使用済ゴム２状態	０
＄マカナ使用済ゴム３状態	０
＄マカナ使用済ゴム４状態	０
＄マカナ使用済ゴム５状態	０
＄マカナ使用済ゴム６状態	０
＄マカナ子宮精液量	０
＄マカナ生えっち解放フラグ	０
＄マカナ登場フラグ	０
＄マカナ頭コス	キャスケット帽
＄マカナ髪型コス	束ね
＄マカナ帽子着用	１
＄ミナコ１回生えっちカウント	０
＄ミナコ１回生えっちフラグ	０
＄ミナコ１回生えっち状態	０
＄ミナコおっぱい露出	０
＄ミナコデカパイバレ	０
＄ミナコノーブラ状態	０
＄ミナコユーザ名	おにーさん
＄ミナコ起動回数	０
＄ミナコ現在のコス	ワイシャツ
＄ミナコ交流ポイント	０
＄ミナコ交流度	０
＄ミナコ使用済ゴム１状態	０
＄ミナコ使用済ゴム２状態	０
＄ミナコ使用済ゴム３状態	０
＄ミナコ使用済ゴム４状態	０
＄ミナコ使用済ゴム５状態	０
＄ミナコ使用済ゴム６状態	０
＄ミナコ子宮精液量	０
＄ミナコ私服お披露目フラグ	０
＄ミナコ生えっち解放フラグ	０
＄ミナコ生えっち初回フラグ	０
＄ミナコ登場フラグ	０
＄ミナコ乳揉みカウント	０
＄ミナコ髪型コス	二つ結び
＄ミニムえっちフラグ	０
＄ミニムユーザ名	パパ
＄ミニム起動フラグ	０
＄ミニム起動回数	０
＄ミニム交流ポイント	０
＄ミニム交流度	０
＄ミニム使用済ゴム１状態	０
＄ミニム使用済ゴム２状態	０
＄ミニム使用済ゴム３状態	０
＄ミニム使用済ゴム４状態	０
＄ミニム使用済ゴム５状態	０
＄ミニム使用済ゴム６状態	０
＄ミニム子宮精液量	０
＄ミニム登場カウント	０
＄ミニム登場フラグ	０
＄ユーザ名	お客さん
＄ユーザ孕ませ経験	０
＄ユナえっちフラグ	０
＄ユナニプレスコス	なし
＄ユナボテえっちフラグ	０
＄ユナボテ腹カウント	０
＄ユナボテ腹状態	０
＄ユナボテ腹目撃済み	０
＄ユナユーザ名	あなた様
＄ユナユーザ孕ませ経験	０
＄ユナ起動回数	０
＄ユナ現在のコス	シスター服
＄ユナ交流ポイント	０
＄ユナ交流度	０
＄ユナ使用済ゴム１状態	０
＄ユナ使用済ゴム２状態	０
＄ユナ使用済ゴム３状態	０
＄ユナ使用済ゴム４状態	０
＄ユナ使用済ゴム５状態	０
＄ユナ使用済ゴム６状態	０
＄ユナ子宮精液量	０
＄ユナ生えっち解放フラグ	０
＄ユナ登場フラグ	０
＄ユナ頭コス	なし
＄ユナ髪型コス	セミロング
＄レレニーヘアピンコス	クロスヘアピン
＄レレニーユーザ名	お客さん
＄レレニー眼鏡コス	丸眼鏡
＄レレニー眼鏡着用	１
＄レレニー起動回数	０
＄レレニー現在のコス	私服セーター
＄レレニー交流ポイント	０
＄レレニー交流度	０
＄レレニー使用済ゴム１状態	０
＄レレニー使用済ゴム２状態	０
＄レレニー使用済ゴム３状態	０
＄レレニー使用済ゴム４状態	０
＄レレニー使用済ゴム５状態	０
＄レレニー使用済ゴム６状態	０
＄レレニー子宮精液量	０
＄レレニー生えっち解放フラグ	０
＄レレニー登場フラグ	０
＄レレニー頭コス	なし
＄レレニー髪型コス	ロング
＄延長済みフラグ	０
＄会話交流カウント	０
＄会話時サーフェス戻し	有効
＄起動回数	1
＄起動中キャラ	フーカ
＄休憩済みフラグ	０
＄現在ポーズ	１
＄交流度移行フラグ	０
＄好感度	０
＄更新チェック機能フラグ	０
＄行動繰り返しキー	space
＄行動繰り返しキーコンフィグ	０
＄行動繰り返し機能フラグ	１
＄行動内容の表示	２
＄最大実績ページ	５
＄残り時間	１２０
＄残ゴム数	３
＄使用済ゴム１状態	０
＄使用済ゴム２状態	０
＄使用済ゴム３状態	０
＄使用済ゴム４状態	０
＄使用済ゴム５状態	０
＄使用済ゴム６状態	０
＄使用済ゴム表示	０
＄時間１ケタ	０
＄時間２ケタ	２
＄時間３ケタ	１
＄時間無限	０
＄次回起動キャラ	フーカ
＄自動挿入ウェイトの倍率	１００
＄自動挿入ウェイトタイプ	無効
＄辞書フォルダ	.,_Common,00_Fuka,02_Minimu,03_Yuna,04_Makana,05_Firio,06_Chinayo,07_Rereni,08_Minako,09_Suria
＄実績１０解放	０
＄実績１１解放	０
＄実績１２解放	０
＄実績１３解放	０
＄実績１４解放	０
＄実績１５解放	０
＄実績１６解放	０
＄実績１７解放	０
＄実績１８解放	０
＄実績１９解放	０
＄実績１解放	０
＄実績２０解放	０
＄実績２１解放	０
＄実績２２解放	０
＄実績２３解放	０
＄実績２４解放	０
＄実績２５解放	０
＄実績２６解放	０
＄実績２７解放	０
＄実績２８解放	０
＄実績２９解放	０
＄実績２解放	０
＄実績３０解放	０
＄実績３１解放	０
＄実績３２解放	０
＄実績３３解放	０
＄実績３４解放	０
＄実績３５解放	０
＄実績３６解放	０
＄実績３７解放	０
＄実績３８解放	０
＄実績３９解放	０
＄実績３解放	０
＄実績４０解放	０
＄実績４解放	０
＄実績５解放	０
＄実績６解放	０
＄実績７解放	０
＄実績８解放	０
＄実績９解放	０
＄実績ヒント詳細表示フラグ	０
＄実績移行フラグ	０
＄実績解放通知	１
＄射精までの時間	１
＄射精ゲージ	０
＄射精擬音感嘆符	０
＄射精擬音表示フラグ	０
＄射精時交流カウント	０
＄射精反応ウエイト	\w9\w8
＄射精反応ウエイトON	０
＄射精閾値	１００
＄終了時の挙動	０
＄宿泊フラグ	０
＄新規更新あり	０
＄生えっちフラグ	０
＄生えっち解放フラグ	０
＄生えっち初回フラグ	０
＄精液ストック	５
＄精液無限	０
＄折り畳み	０
＄前戯カウント	０
＄挿入時暴発許可フラグ	０
＄挿入中カウント	０
＄挿入中フラグ	０
＄総ふとももコキ射精回数	０
＄総オナホ射精回数	０
＄総ゴム射精回数	０
＄総パイズリ射精回数	０
＄総フェラ射精回数	０
＄総自慰射精回数	０
＄総手コキ射精回数	０
＄総膣内射精回数	０
＄他客使用済ゴム１状態	０
＄他客使用済ゴム２状態	０
＄他客使用済ゴム３状態	０
＄他客使用済ゴム起動	０
＄中出し回数	０
＄喋り間隔	１８０秒
＄喋り間隔誤差	１０％
＄追加ゴム使用フラグ	０
＄透過断面図表示	０
＄童貞卒業相手	フーカ
＄妊娠確立100フラグ	０
＄抜いたキャラ送信	０
＄抜いた即時送信	０
＄筆おろしバックアップ	０
＄筆おろしフラグ	０
＄筆おろしプレイＦ	０
＄表示中ミニイベント	０
＄表示中実績ページ	１
＄表示中話題一覧ページ数	１
＄暴発許可フラグ	０
＄膣内射精擬音表示位置	０
＄膣内射精後フラグ	０
